.....#.............#...#...............................................
.#####.#.#########.##..#..#............................................
.#.....#.....#...#.....#...............................................
.#.####.####.#.#..##.##..#.............................................
.#.#...#...#.#.#.#...#.................#...............................
.#.#.#.#.#.#.#.#.###.#.#...............................................
.....#.#.#...#.#...#.#.......#.........................................
########.###.#.###.#.##................................................
.........#...#...#.#.#.................................................
.#######.#######.#.#.#.####.##.........................................
...#.....#.......#.#.#.................................................
.#.#####.#.####.##.#..########.........................................
.#.....#.#.....#.#.#.#.....#...........................................
####.#.#######.#.#.###.#.#.#.####...#..................................
...#.#.......#...#.....#.#.#.....#.....................................
.#..##.#.#####.#########.#.###...#.....................................
.....#.#.......#...#.....#.#...#.#.#...................................
..##.#.########..#.#.#####.#.#####.#.#.................................
.....#.......#.#.#...#.....#...#...#...................................
.....##.####.#.#.####..#######.#...#...................................
.......#...#...#.#...#...#.....#.#.....................................
...###.#...#####.#.#.###.###.###.#..##.#...............................
.............#...#.#...#.....#.....#...............#...................
.#####.##..#.#.####..#.#.#####.####.................#..................
.........#.....#...#.....#...#.....................#...................
.#......##.####....#.#####.#......##...................................
...........#.....#.#.....#.#.....#.....................................
.........###.#####.#######.##......................#...................
.............#.....#.....#.............................................
...........###....##.#.#...##..............................#...........
.............#.................#.......................................
..........##.###.#..##.......................#...#...#.#...............
.....#.....#...#...........#.................#.........................
..................#.##........................#.#..###....#..##........
...........#.........................#.....#.........#...........#.....
...................................#....#..#..#....#.##......#...#..###
...........................................#.#.....#...................
..........................................##.#..######...###.....#.#.#.
...........................................#.#.....#.................#.
.........................................#.#.#...#.#.#...#...#.#.#####.
.............................................#...#...#...........#...#.
.......................................#.#..#.######.##....###.###.###.
...........................................#.......#.....#.#...#.......
.....................................#.....#.#####.####..#...###.####.#
.......................................#...#.#...#.....#...#...#.....#.
.................................#...#.##..#.#.#.#####.#.#.###..####.#.
.....................................#.#.#...#.#.....#.#.....#.#.....#.
.................................#.....#.#####.#.###.#.#.####..#.####..
.......................................#.....#.#...#.#.........#.#.....
.....................................#.#.#.#.#####.#############.#####.
.......................................#.#.#.......#...........#.......
...................................#.#.#.#.#######.#.##.##.###########.
.....................................#.#.#...#.....#.#.#...#.........#.
..................................####.#.###.#.##.##.#.#.###.#####.#.#.
.......................................#.#...#.....#.#.#.....#...#...#.
................................#...######.#######.#.#.#######.#.#.###.
.................................#...#.....#.....#.#...#.......#.#.....
............................#......#.#.#...#.###.#####.###.#.##########
...................#...............#.#.#...#.#.#.....#...#.#.#.........
........................#..##..#.###.#.#####.#.#####.###.#.###.#.###.#.
...........................#.........#.....#.......#.....#.#...#...#.#.
..........................##.##.##.###.###.#####.#.#######.#.#####.#...
.........................#.........#.#.#.#.....#.#...........#...#.#...
....................#....#..########.#...#.#####.#########...#.#.#.#.#.
.........................#.#.......#...#.#.#...#.........#...#.#...#...
.....................#.#.#.#.###.###.##..#.#.#.#########.#..##..######.
.......................#.#.#.#.#...#.....#.#.#.........#.#.#...#.....#.
.........................#.#...###.#.#...#.#.###.###.#.#.#.#.###.###.##
.........................#.#.#.#...#.#.#.#...#.#.#...#...#.#.......#...
.........................#.#...#.###.#.#.#####.#.#.######.#.##########.
...........................#...#.......#.......#.......................
