.#..##........#.##.#..##...........#.........#...#..#.#..#.....#.....#.
.#####.#.#########.###.#.#####.###.#.#######.###.###.#.###.#.###.###.##
.#.....#.....#...#...#.#.#.#.#...###.......#...#.....#.#...#...#.#.#...
.#.#########.#.#.###.###.#.#.###.#########.###.###.#####.#####.#.#.###.
.#.#.#.#...#.#.#.##.##...#.#...#.#.....#.....#.#...#.....#.#.#...###...
.#.#.#.#.#.#.#.#.#####.#####.###.#.###.#.#####.#####.#######.#######.#.
....####.#...#.#...#.#.......#...#.###.#.#.....#.....##.#..##..#...#.##
########.###.#.###.#.#######.#.###.###.#.#.#####.###########.#.#.###.#.
.........#..##...#.#.#.......#...#...#...#.....#...#...###..##...#...#.
.#######.#######.#.#.#.#########.###.#########.###.#.#.###.#######.###.
...##...##.......#.#.#.........#....##.......#..##...#.#...#.....#...#.
.#.#######.#######.###########.###############.#######.#.#.#########.#.
.#.....#.#.....#.#.#.#.....#.#.....#.#.#...#.#..........####.#.#.#.#.#.
####.#.#######.#.#.###.#.#.#.#####.###.#.###.###############.#######.##
...###......##...#.....#.#.#...#.#.#...#.#.#.#.##.#....#.....#.....#...
.#.###.#.#####.#########.#.#####.#.#.###.#.#####.#############.#######.
.#...#.#.......#...#.....#.#...#.#.#.#...##.##.##..#.#.#...###...#.....
.###.#.#########.#.#.#####.#.#####.#.#######.#.#####.###.#############.
.#...##..#.#.#.#.#...##...###..#...#.#.#...##..##..##..#.#.#.#...###...
.###.#########.#.#####.#########.#########.#.#######.###.#######.#.#.##
...#...#...#...#.#..###..#.#...#.#...#.#.###.#.#...#...#.....##.##.#...
##.###.#.#.#####.#.#.###.###.###.#.#######.###.#.#.#########.#.###.###.
...#.#...#...#...###...#.....#....##....##########.#..#..###.###...#...
.###########.#.#########.#####.#####.#####.#.###########.#####.#.###.##
.....#...#.....#...#..#.##...#.#..#..###.#.#...#.#.###.#...#...#.#.#...
.###.###########.#.#.#####.#.#.#.#####.###.###.###.#.#############.###.
.#...#..#..#.....#.#..##.#.#...#.###...#...##..#.###.####........#...#.
.#.#########.#####.#######.#######.#######.#.#########.#.###########.#.
.#.......#...#.....#.....#...#.#.#.#.#.#...#...#...#.##..##....#.#.#.#.
.#######.#.###.#####.###.#.###.#######.#.#.#########.#####.###.#.#.###.
...##.##.#...#...#...#.#...#...#.#..##.#.#.#..#....###.#...#.....#.....
##.#.###.###.###.#.###.#####.###.#.#####################.#########.####
..##.#...#.#...#...#......##.#...###.#...#...#.#.##..#.#.........#.....
.###.#.#######.#############.#######.#.#.#.###########.###############.
.#.#.#.##..#...#....##.#####.#.#...#.#.#.#.#.........#...#.#..##.#.....
.#.###.###.#.#########.#.###.#.#######.###.#.#############.#.###.#.####
##.###...#.#.##....##.##...#####..##.#...#.###..##.#..##.#.#.#.###.#...
####.###.###.#.#.#########.#.#####.###.#######.#######.#.#####.###.#.#.
..##.#.#.....#####.#..##..##.#.##..#.#.#..##.#.##.##.#.#.#.#.#.###...#.
.#####.#######.#.#############.#.###.#.#.#.###.###.#.###.#############.
##...###.#....##.##..#.#..#..#.#...###.#.#.#.##..##..#..##.#.#...#.#.#.
.#.#####.#########.###.#.#.#######.#.###################.#.###.#######.
.#...###...#.....#.#..##.#..##.####..#####.#..##...#.....#.#...#.......
.###.###.###.###.#######.###.#.#.#######.#########.#######.#.###.######
.....#...#..##.#.#.##.##...#..##...#...##.##.#...#..#..#.###...#.....#.
.#####.###.###.###.###.###.#####.#####.###.#.###.#####.#######.#####.#.
#..##....#####.##.##.#..####.....#.#.#.#.#...#.#.....#.##.#..#.#.....#.
####.#######.#.#.#########.#########.#.#.#####.#.###.#.#######.#.######
..##...##..#.#.#.#...#.#.#.#.#.###...#.#....##.##.##.#......#.##.#..#..
########.###.###.#.###.#.###.###.#####.###########.#############.######
...##....#.#.##..#.###.#...#.#.#..##...#####..##...#..........##.......
##.#######.#######.#.#.#.#.#########.###.#.#######.#.#####.###########.
.###.#.###...#.#.#.#.###.#...#..##.#.#.#.##.####..##.#.#...#........##.
.#.#.#########.#####.#.#.###.#.#######.#####.#.#####.#.#.###.#####.#.#.
.###..#.##.....#.....#.###..##.#....#.####...#..#..#.#.#.....#...#.#.#.
.#.###.#.#.#####.#####.#.#####.###.#######.#######.#.#.#######.#.#.###.
.#.#.#.#.#.....#.#.#.#.###..##...#...#.#..##.....#.#...#......##.#.....
.###.###.###.#####.#.###.#######.#.###.#####.###.#####.#####.##########
.#.#####.....##..#.#.#...##...##.#.#.###...#.#.#.....#...#.#.###....##.
.#####.#######.#######.###.###.#.###.#.#####.#.#####.###.#.#####.#####.
#....#..##.#...##..#...#...###...##..#....##.....#.#.....###.#.#.#.#.##
.#.#####.#.#############.###.#############.#####.#.#######.#.#######.#.
.##......#.#.....#...#.#.##.#.##...#.###.##....#.#...#.......##.##.###.
.#########.###.###.###.#.###########.#.#.#######.#############.#.#.#.##
.#.#..#......#.....#...#.#.#..###.###..#####...#.........#...####.###..
##.#.#########.#######.#.#.#.###.###.###.#.#.#.#########.#####.#######.
###.##.....####..#.#.#.#.###.####..#.#.#.#.#.#.....#...#.#.##.#####.##.
.#####.#########.#.#.#.#.#####.###.#.#.#.#.#.###.###.#.#.#.#.###.###.##
..#..#.#...###...#.#...#.###.#.#...#.###.#...###.#...#...#.##......#...
####.#.#.###.#####.#####.#.###.#.###.#.#.#####.#.#.###################.
.#.##.##....#..#...#...#...#..##.......##......#.#.....................
